........####..............
........####..............
........##......@@@@@@....
@@..##..##..........@@....
@@..##......##............
@@..##......##............
##..######..####..~~~~..~~
##..######..####..~~~~..~~
##......##........~~......
..................~~......
........~~~~..~~~~~~..####
....##..~~~~..~~~~~~..####
####....~~##..###.........
####....~~##..###.........
........~~...........@@...
........~~...........@@...
~~~~~~..~~..@@..##...@....
~~~~~~..~~..@@..##...@....
.....................@####
......####...........@####
........##########........
........##......####......
######............####....
####.......####.....##....
##.........#**#...........
...........#**#...........