........##......##........
........##......##........
..//////##................
##//////##................
##//////..................
////////..................
////////......##..#######.
////////......##..#######.
////////########..##...#..
////////######....##...#..
////////....##.........#..
////////....##.........#..
..//........@@@@@@....//..
..//........@@@@@@....//..
..................////////
..##..##..........////////
###..####..#######////////
###..####..#......////////
..........##......////////
..........##..####////////
##....@.......####//////..
##....@...........//////..
####..@...........//////..
####..@....####...//////..
@@####.....#**#...##......
@@####.....#**#...##......