......@@......@@..........
......@@......@@..........
..##..@@......##..##..##..
..##..@@......##..##..##..
..##........####..##@@##..
..##........####..##@@##..
......##..........@@......
......##..........@@......
//....##....@@....##//##@@
//....##....@@....##//##@@
////......##....@@..//....
////......##....@@..//....
..######//////@@....//....
..######//////@@....//....
......@@//##..##..##..##..
......@@//##..##..##..##..
@@##..@@..##..##......##..
@@##..@@..##..##......##..
..##..##..######..##@@##..
..##..##..######..##@@##..
..##..##..######..........
..##..##..######..........
..##..............##..##..
..##.......####...##..##..
..##..##...#**#...######..
..##..##...#**#...######..